A - ADDED
E - EDITED
P - POSTED
U - UNPOSTED
C - CANCELLED
X - DELETED
V - VIEWED
I - INQUIRED
R - PROCESSED
G - GENERATED
O - BATCH POSTING
AA - ADD DETAILS
EE - EDIT DETAILS
UU - UNPOST DETAILS
CC - CANCEL DETAILS
XX - DELETE DETAILS
PP - POSTED DETAILS
AP - APPROVED
DS - DISAPPROVED
AT - ATTACHED
DT - DETTACHED
B - BILLED
RD - RELEASED
UR - UNREELEASED
JI - CLOCK IN
JO - CLOCK OUT
AS - ASSIGNED
RE - REMOVED
UP - UPLOAD
RC - RECOVER
JP - JOB PASSED
JF - JOB FAILED
CF - CONFIRMED
M - IMPORTED
MM - IMPORTED DETAIL
UD - UPLOAD DETAILS